NO ./textures/horror/north.xpm
          SO      ./textures/horror/south.xpm
WE          ./textures/horror/west.xpm
       EA       ./textures/horror/east.xpm

        F 80,70,70
  C        0,0,0



1111111111111111111111111111111111111111111111111111111111111111111111
1000000S00000000000000000000000000000000000000000000000000000000000001
1011110001110000001110000000Z0001111000000000001110000000Z00011110001
100000000000000000000000000000000000000000000000000000000000000000001
1111111D1111111111111110000000000000001111111111111110000000000000001
100000000000000000000111111111111111111111111111111111111D11111111111
100000000Z00000000111000000000000100001000000Z00000000000000000000001
11111111111100001111010111011111111111111111111111D111111111111111111
100000000000011100000000Z000000000Z0000000000000000000000000000000001
10000000Z00000001100000111000100000000000000000000000000000000Z000001
11110000000000000010000000100111111111111111111111111D111111111111111
1000000000Z0000000000000001101000000000000000000000000000000000000001
1000000000000000110000000000100000000Z0000000000Z000000000000000000001
1100000111010101111101111000111111111111D1111111111111111111111111111
1000000001111111111111111010000000000Z0000000000000000000000000000001
1000000000000000Z00000001000000000000000000000000000000Z0000000000001
100000000000000001110111111111111111D111111111111111D1111111111111111
100000000Z0000000000000000000000000000000000000000Z00000000000000001
111111D11111111111110111111111111111111111D1111111111111111111D111111
10000000000000000000000000000000000Z0000000000Z0000000000000000000001
100000000000000011000000000010000000000000000000000000000000000000001
1100000111010101111101111000111111111111D1111111111111111111111111111
100000000111111111111111101000000000000000000000000000000000000000001
1000000000000000Z0000000100000000000000000Z00000000000000000000000001
1000000000000000011101111111111111111111111111111111111D1111111111111
100000000Z00000000000000000000000000000000000000000000000000000000001
11111D11111111111111111D1111111111111111111D1111111111111111111111111
100000000000000000000000000000000Z0000000000000000000000000000000Z0001
100000000Z0000000011100000000000010000100000000000000000Z000000000001
1111111111110000111101011101111111111111111D1111111111111111111D11111
10000000000001D100000000Z00000000Z00000000000000000000000Z000000000001
1000Z00000000000110000011100010000000000000000000000000Z0000000000001
1111000000000000001000000010011111111111D11111111111111111D1111111111
100000000Z00000000000000001101000000000000000000000000000Z00000000001
1000000000000000110000000000100000000000000000Z0000000000000000000001
111111D11110101011111011110001111111111D111111111111111111D11111111111
10000000011111111111111110100000000000000000000Z0000000000000000000001
1000Z00000000000Z0000000100000000000000000000Z0000000000000000Z000011
1000000000000000011101D1111111111111111D11111111111111111111111111111
100000000Z0000000000000000000000000000000Z000000000000000000000000001
1111111111111111111D11111111111111111111111111111D1111111111111111111
10000Z00000000000000000000000000000000000000000000000000Z000000000001
111111111111111111111111111111111111111111111111111111111111111111111
