NO ./textures/horror/north.xpm
          SO      ./textures/horror/south.xpm
WE          ./textures/horror/west.xpm
       EA       ./textures/horror/east.xpm

        F 80,70,70
  C        0,0,0

      1111111111111111111111111111111111111111111111
      1ZZZZZZZZZZZZZZZZZZZZZZZZZZZZZZZZZZZZZZZZZZZZ1
      1ZZZZ000000000ZZZ00000000000ZZZZZZZZZZZZZZZZZ1
      1ZZZZ0000000000000000000000000000ZZZZZZZZZZZZ1
1111111ZZZZ00ZZZZZZ0000ZZZZZZZZZZZZZZ00ZZZZZZZZZZZZ1
1000001000000ZZZZZZZ00ZZZZZZZZZZZZZZZ00ZZZZZZZZZZZZ1
100E00D000000ZZZZZZZZZZZZ000000000ZZZ00ZZZZZZZZZZZZ1
1000001ZZZZ00ZZZZZZZZZZZ00000000000ZZ00ZZZZZZZZZZZZ1
1111111ZZZZ00ZZZZZZZZ00000ZZZZZZZ000Z00ZZZZZZZZZZZZ1
      1ZZZZ00000000000000ZZZZZZZZ000000ZZZZZZZZZZZZ1
      1ZZZZ0000000000000ZZZZZZZZZZZ000ZZZZZZZZZZZZZ1
      1ZZZZZZZZZZZZZZZZZZZZZZZZZZZZZZZZZZZZZZZZZZZZ1
      1111111111111111111111111111111111111111111111
