NO ./textures/horror/north.xpm
          SO      ./textures/horror/south.xpm
WE          ./textures/horror/west.xpm
       EA       ./textures/horror/east.xpm

  C        0,0,0
        F 80,70,70


1111111111111111111111111111111111111111
1000000000000000000000000000000000000001
1011110001110000001110000000Z00011110001
100000000000000000000000000000000000001
111111100111111111111110000000000000001
1000000S0000000000000111111111111111111
100000000Z00000000111000000000000100001
111111111111D11111110101110111111111111
100000000000011100000000Z00000000000001
100000000000000011000001110001000000001
111100000000000000100000001001111111111
100000000000000000000000001101000000001
100000000000000011000000000010000000001
1111D1111101010111110111100011111111101
100000000111111111111111101000000000001
1000000000000000Z000000010000000000001
100000000000000001110111111111111111101
100000000Z00000000000000000000000000001
111111111111D1111111011111111111D111111
100000000000000000000000000000000000001
100000000000000011000000000010000000001
110000011101010111110111100011111111101
100000000111111111111111101000000000001
1000000000000000Z000000010000000000001
100000000000000001110111111111111111101
100000000Z00000000000000000000000000001
111111111111111111111111111111111111111
